R 1280  960
NO  ./img/bunkerwall.xpm
  SO      ./img/labwall.xpm     
WE ./img/moldystonewall.xpm             
EA ./img/stonewall.xpm
S ./img/armor.xpm ./img/armor.xpm
C 191,192,193
F 61,62,63

 111111   11111
110000111110001111
100000000000000001
100101000010100001
100000000000000001
100000000000111111  1111111111
1000000000001       1000000001
111000000020111111  1111000001
  110011000110000111   1000001
11100010000000000001   1000001
100000000000000000011  1000001
111000101111000000001111000001
100000000000000000000000000001
111000100011110000000100000001
100000000000010000001100000001
111000100000010000000110000001
100000000001110000000100000001
111000100000000000000000000001
100S00000000000000011111111111
10000000000000000001
10000111110000000111
100001   100000111
111111   111111111
