   R 1280 960
NO  ./img/bunkerwall.xpm
 SO ./img/labwall.xpm     
WE ./img/moldystonewall.xpm             
           EA ./img/stonewall.xpm

S          ./img/armor.xpm
C   191,192,193



F 61,62,63



111111   11111
100001111100011111
100000000000000001
100101000010100001
100000000000000001
100000E00020111111
1000000000001
111000000000111111
  110011000110000111
11100010000000000001
10000000000000000001
10000111110000000111
100001   100000111
111111   111111111
