R 1280 960
NO ./img/bunkerwall.xpm
SO ./img/labwall.xpm
WE ./img/moldystonewall.xpm
EA ./img/stonewall.xpm

S ./

11111111111111111111
10000000000000000001
10000000000000000001
10001010101010100001
10000000000000000001
10000000000000100001
10000000000000100001
10000000000000100001
10011100000111100001
10000100000000000001
10000100000000000011
10000100000000000111
11111111111111111111