   R 1280 960
NO  ./img/bunkerwall.xpm
 SO ./img/labwall.xpm     
WE ./img/moldystonewall.xpm             
           EA ./img/stonewall.xpm

S          ./img/armor.xpm
C   191,192,193



F 61,62,63



111111111    1111111
100000001111110000011111
100000000000000000000001
100010101000001010100001
100000000000000000000001
100000000E00002000111111
1000000000000000001
111100000000000000111111
   11100011000011110000111
11110000010100000000000001
10000100111111000000000111
100001001    10000000111
111111111    11111111111

